#
# Format des lignes : <chaine a trouver><tabulation><chaine de remplacement>
#
B.C.P	BATAILLON DE CHASSEURS A PIEDS
CHARLES DE GAUL	CHARLES DE GAULLE
CHP	CHAMP
DOCT	DOCTEUR
DELATTRE DE TASSIGNY	DE LATTRE DE TASSIGNY
ENFTS	ENFANTS
FBG	FAUBOURG
FBOURG	FAUBOURG
FG	FAUBOURG
GDS	GRANDS
GDES	GRANDES
HTS	HAUTS
HTES	HAUTES
JEAN B	JEAN-BAPTISTE
N D	NOTRE DAME
N DAME	NOTRE DAME
NVE	NEUVE
ORADOUR SURGLANE	ORADOUR SUR GLANE
PGE	PASSAGE
R.A.M	REGIMENT D ARTILLERIE DE MONTAGNE
R.T.M.	REGIMENT DE TIRAILLEURS MAROCAINS
RD PERE	REVEREND PERE
R P	REVEREND PERE
DUCHESSEANNE	DUCHESSE ANNE
LEVISTRAUSS	LEVI STRAUSS
PORTORICHE	PORTO RICHE
CHEV	CHEVALIER
LNANT	LIEUTENANT
SAINTCHARLES	SAINT CHARLES
VIANSSONPONTE	VIANSSON PONTE
D.I.A.  DIVISION D'INFANTERIE ALGERIENNE
R.S.A.R.  REGIMENT DE SPAHIS ALGERIENS DE RECONNAISSANCE
R.I.  REGIMENT D'INFANTERIE
